XXXXXXXXXX
XXXXXXXXXX
XXUU---HXX
XXB--A-HXX
XXBGGA-H--
XXB--A--XX
XXC---EEXX
XXC-DDD-XX
XXXXXXXXXX
XXXXXXXXXX