XXXXXXXXXX
XXXXXXXXXX
XXUTTX--XX
XXU--AHHXX
XXBGGA----
XXB-VLLEXX
XXMMV--EXX
XXCCDDDEXX
XXXXXXXXXX
XXXXXXXXXX