XXXXXXXXXX
XXXXXXXXXX
XX------XX
XXACC-U-XX
XXAGG-U---
XXBIIIU-XX
XXB-T---XX
XX--TYY-XX
XXXXXXXXXX
XXXXXXXXXX