XXXXXXXXXX
XXXXXXXXXX
XX------XX
XXA---C-XX
XXAGG-C---
XXMBBBC-XX
XXM-F---XX
XX--FEE-XX
XXXXXXXXXX
XXXXXXXXXX