XXXXXXXXXX
XXXXXXXXXX
XX------XX
XX---AA-XX
XX-GG-----
XX------XX
XX------XX
XX------XX
XXXXXXXXXX
XXXXXXXXXX