XXXXXXXXXX
XXXXXXXXXX
XX--HHHFXX
XX-----FXX
XXGGA--F--
XX--A-EEXX
XXB-A-D-XX
XXBCCCD-XX
XXXXXXXXXX
XXXXXXXXXX