XXXXXXXXXX
XXXXXXXXXX
XXAA-TYNXX
XXBB-TYNXX
XXCDGGYN--
XXCDF---XX
XXE-FQQ-XX
XXE-RRR-XX
XXXXXXXXXX
XXXXXXXXXX