XXXXXXXXXX
XXXXXXXXXX
XXAA-TYNXX
XXBB-TYNXX
XXCDGGY---
XXCDF---XX
XXE-FQQ-XX
XXE--RR-XX
XXXXXXXXXX
XXXXXXXXXX