XXXXXXXXXX
XXXXXXXXXX
XX--YYYFXX
XX-----FXX
XXGGA--F--
XX--A-EEXX
XXC-A-D-XX
XXCBBBD-XX
XXXXXXXXXX
XXXXXXXXXX