XXXXXXXXXX
XXXXXXXXXX
XX------XX
XX--BFY-XX
XXGGBFY---
XXAACFY-XX
XX-DC---XX
XX-DEE--XX
XXXXXXXXXX
XXXXXXXXXX