XXXXXXXXXX
XXXXXXXXXX
XXNN-IIIXX
XX---OUUXX
XXAGGO-Y--
XXA-CDDYXX
XXBBC--YXX
XX--CEEEXX
XXXXXXXXXX
XXXXXXXXXX