XXXXXXXXXX
XXXXXXXXXX
XX--ABBCXX
XX--AD-CXX
XXGGAD-C--
XXEIII--XX
XXEHHJK-XX
XXFF-JK-XX
XXXXXXXXXX
XXXXXXXXXX