XXXXXXXXXX
XXXXXXXXXX
XXCCC-D-XX
XX--A-D-XX
XXGGA-DB--
XXUEEIIBXX
XXUFFH-ZXX
XXOOOH-ZXX
XXXXXXXXXX
XXXXXXXXXX