XXXXXXXXXX
XXXXXXXXXX
XX--Y-FFXX
XX--Y--EXX
XXGGY--E--
XX-ABBBEXX
XX-ACCD-XX
XX----D-XX
XXXXXXXXXX
XXXXXXXXXX