XXXXXXXXXX
XXXXXXXXXX
XX--UVVVXX
XX--UY-OXX
XXGGFY-O--
XXAAFIIOXX
XXBCDD--XX
XXBC--EEXX
XXXXXXXXXX
XXXXXXXXXX