XXXXXXXXXX
XXXXXXXXXX
XX--BBBCXX
XX--A--CXX
XXGGA--C--
XX------XX
XX--DDEEXX
XX------XX
XXXXXXXXXX
XXXXXXXXXX