XXXXXXXXXX
XXXXXXXXXX
XXA----BXX
XXA----BXX
XXGG---B--
XX----CCXX
XX--D---XX
XX--DEEEXX
XXXXXXXXXX
XXXXXXXXXX