XXXXXXXXXX
XXXXXXXXXX
XXBBYPPOXX
XXA-Y-UOXX
XXAGG-UO--
XXCETTHHXX
XXCE-NMMXX
XXDD-N--XX
XXXXXXXXXX
XXXXXXXXXX