XXXXXXXXXX
XXXXXXXXXX
XXBBB-CDXX
XXA---CDXX
XXA-GGCD--
XXA-HE--XX
XX--HEFFXX
XXUUUE--XX
XXXXXXXXXX
XXXXXXXXXX