XXXXXXXXXX
XXXXXXXXXX
XX-OO-IIXX
XX--AUUUXX
XXGGAY----
XX--BY-FXX
XXZVBDDFXX
XXZVCCEEXX
XXXXXXXXXX
XXXXXXXXXX