XXXXXXXXXX
XXXXXXXXXX
XXABCCD-XX
XXABEFD-XX
XXGGEF----
XXZZEH--XX
XXN--H--XX
XXNYYUU-XX
XXXXXXXXXX
XXXXXXXXXX