XXXXXXXXXX
XXXXXXXXXX
XX--AUUUXX
XXYYAHHNXX
XXGGAB-N--
XXECCB--XX
XXEDDB--XX
XXFF----XX
XXXXXXXXXX
XXXXXXXXXX