    XXXXXXXXXX
    XXXXXXXXXX
    XX--B---XX
    XX--B---XX
    XXGGB-----
    XX-A--E-XX
    XX-ACCE-XX
    XX----E-XX
    XXXXXXXXXX
    XXXXXXXXXX
