XXXXXXXXXX
XXXXXXXXXX
XX--AAACXX
XX--B--CXX
XXGGB--C--
XX------XX
XX--DDEEXX
XX------XX
XXXXXXXXXX
XXXXXXXXXX