XXXXXXXXXX
XXXXXXXXXX
XX----A-XX
XX----A-XX
XX--GGA---
XX---B--XX
XX---BCCXX
XX------XX
XXXXXXXXXX
XXXXXXXXXX