XXXXXXXXXX
XXXXXXXXXX
XX--A---XX
XX--A---XX
XXGGA-----
XX----D-XX
XXBCC-D-XX
XXB---D-XX
XXXXXXXXXX
XXXXXXXXXX