XXXXXXXXXX
XXXXXXXXXX
XXA--C--XX
XXA--C--XX
XXGG-C----
XX-BB-EEXX
XX------XX
XX---FFFXX
XXXXXXXXXX
XXXXXXXXXX