XXXXXXXXXX
XXXXXXXXXX
XX--A---XX
XX--A--EXX
XXGGA--E--
XX-B----XX
XX-BCCD-XX
XX----D-XX
XXXXXXXXXX
XXXXXXXXXX