XXXXXXXXXX
XXXXXXXXXX
XX--A---XX
XX--A---XX
XXGGB-----
XX--B--DXX
XX--B--DXX
XXCCC--DXX
XXXXXXXXXX
XXXXXXXXXX