XXXXXXXXXX
XXXXXXXXXX
XXA--D--XX
XXA--D-CXX
XXGG-B-C--
XXTTTB-CXX
XX-YFF--XX
XX-YEE--XX
XXXXXXXXXX
XXXXXXXXXX