XXXXXXXXXX
XXXXXXXXXX
XXABBC--XX
XXA--C--XX
XXAGGC----
XX--EFFFXX
XX--E--DXX
XX--HHHDXX
XXXXXXXXXX
XXXXXXXXXX