XXXXXXXXXX
XXXXXXXXXX
XX--B-HHXX
XX--B--FXX
XXGGB--F--
XX-ACCCFXX
XX-ADDE-XX
XX----E-XX
XXXXXXXXXX
XXXXXXXXXX