XXXXXXXXXX
XXXXXXXXXX
XX----BEXX
XX--AABEXX
XX--GGCE--  
XX--H-C-XX
XX--HFDDXX
XX--HF--XX
XXXXXXXXXX
XXXXXXXXXX