XXXXXXXXXX
XXXXXXXXXX
XXAAB-CCXX
XX--B---XX
XX--GGD---
XXUUU-DHXX
XXEEFFFHXX
XX-----HXX
XXXXXXXXXX
XXXXXXXXXX