XXXXXXXXXX
XXXXXXXXXX
XXABBCC-XX
XXA-D---XX
XXGGDFH---
XX---FH-XX
XXEEEFH-XX
XX------XX
XXXXXXXXXX
XXXXXXXXXX