XXXXXXXXXX
XXXXXXXXXX
XX---BAAXX
XX---B-EXX
XXGG-CDE--
XX---CDEXX
XXYHHHF-XX
XXY---F-XX
XXXXXXXXXX
XXXXXXXXXX