XXXXXXXXXX
XXXXXXXXXX
XXAAB-CCXX
XX--B---XX
XX--GGD---
XX----D-XX
XXEEFFFHXX
XX-----HXX
XXXXXXXXXX
XXXXXXXXXX