XXXXXXXXXX
XXXXXXXXXX
XX-AB-TTXX
XX-AB---XX
XXGGB-----
XXECCUUZXX
XXEDDYXZXX
XXFFFYXZXX
XXXXXXXXXX
XXXXXXXXXX