XXXXXXXXXX
XXXXXXXXXX
XXIIN-CCXX
XXOON-ABXX
XXH-GGAB--
XXHUUUABXX
XXH--FDDXX
XXYY-FEEXX
XXXXXXXXXX
XXXXXXXXXX