XXXXXXXXXX
XXXXXXXXXX
XX--ACCDXX
XX--AB-DXX
XXGGAB-D--
XXUEEE--XX
XXUFFXZ-XX
XXOO-XZ-XX
XXXXXXXXXX
XXXXXXXXXX