XXXXXXXXXX
XXXXXXXXXX
XX--UVVVXX
XX--UY--XX
XXGGFY-O--
XXAAFIIOXX
XXBCDD-OXX
XXBCEE--XX
XXXXXXXXXX
XXXXXXXXXX